·······································
····=====·····················|===|····
····||0||=====================||*||····
····=====·····················|===|····
····Player···················Monster···
·······································