========================
||····················||
||····················||
||····················||
||····················||
||····················||
||··0·················||
========================
